#######################################
# Syntax Coloring Map For LilyGO-T-TWR By lewis He
# github:https://github.com/Xinyuan-LilyGO/T-TWR
#######################################

#######################################
# Datatypes (KEYWORD1)
#######################################
TWRClass	KEYWORD1
TWR_Version	KEYWORD1
CallbackFunction	KEYWORD1
SysSetting	KEYWORD1
teCXCSS	KEYWORD1
RadioType	KEYWORD1
FirmwareType	KEYWORD1
sa868_data	KEYWORD1
SA868	KEYWORD1


#######################################
# Methods and Functions (KEYWORD2)
#######################################
begin	KEYWORD2

getVersion	KEYWORD2
getOLEDAddress	KEYWORD2
getBandDefinition	KEYWORD2
routingIO2Downloader	KEYWORD2
routingMicrophoneChannel	KEYWORD2
routingSpeakerChannel	KEYWORD2
saveConfigure	KEYWORD2
enableBeep	KEYWORD2
isEnableBeep	KEYWORD2
getSetting	KEYWORD2
enablePowerOff	KEYWORD2
attachLongPressed	KEYWORD2
attachClick	KEYWORD2
tick	KEYWORD2
selectEsp2Amp	KEYWORD2
selectIO2Radio	KEYWORD2
enableRadio	KEYWORD2
disableRadio	KEYWORD2
enableGPS	KEYWORD2
disableGPS	KEYWORD2
enableSD	KEYWORD2
disableSD	KEYWORD2
enableDownloadSwitch	KEYWORD2
disableDownloadSwitch	KEYWORD2
enableMicrophone	KEYWORD2
disableMicrophone	KEYWORD2
ledToggle	KEYWORD2
isChargeDone	KEYWORD2
isCharging	KEYWORD2

setPins	KEYWORD2
firmwareType	KEYWORD2
setRadioType	KEYWORD2
isConnected	KEYWORD2
factoryNVS	KEYWORD2
sleep	KEYWORD2
wakeUp	KEYWORD2
receive	KEYWORD2
highPower	KEYWORD2
lowPower	KEYWORD2
isTransmit	KEYWORD2
setTxFreq	KEYWORD2
setRxFreq	KEYWORD2
setRxCXCSS	KEYWORD2
setTxCXCSS	KEYWORD2
setSquelchLevel	KEYWORD2
transmit	KEYWORD2
scanRF	KEYWORD2
setGroup	KEYWORD2
setBandWidth	KEYWORD2
setVolume	KEYWORD2
getRSSI	KEYWORD2
setFilter	KEYWORD2
getVolume	KEYWORD2
enableLowPass	KEYWORD2
enableHighPass	KEYWORD2
enableEmpHassis	KEYWORD2
getSettting	KEYWORD2
saveConfigure	KEYWORD2


#######################################
# Constants (LITERAL1)
#######################################

LILYGO_TWR_REV2_0	KEYWORD3
LILYGO_TWR_REV2_1	KEYWORD3
LILYGO_TWR_AUTO	KEYWORD3
TWR_IO_MUX_RADIO	KEYWORD3
TWR_IO_MUX_PIN	KEYWORD3
TWR_MIC_TO_ESP	KEYWORD3
TWR_MIC_TO_RADIO	KEYWORD3
TWR_ESP_TO_SPK	KEYWORD3
TWR_RADIO_TO_SPK	KEYWORD3
TWR_REV2V0	KEYWORD3
TWR_REV2V1	KEYWORD3
SA8X8_UNKONW	KEYWORD3
SA8X8_UHF	KEYWORD3
SA8X8_VHF	KEYWORD3
SA8X8_OPENRTX	KEYWORD3
SA8X8_NICERF	KEYWORD3
